S..~...^^.
.#.^..#..G
..#..~~...
..#..#....
..#..#....
..#..#....
..#..#....
..#..#....
..#..#....
..........