S.~~.^..#...~~..^^..~...#.^~..^..~.#..^.
..#..^^..~~.^...#..~~..^^..~..#.^~..~..~
.~..#.^~..^^...~..#..^...~~..^^.#..~..~.
..^^..~..#..~.^..~~..^..#...^^..~..#..~.
.~.^^..~~..^..#..~..^^..~..#..^..~~..^..
..~.~#..^^..~..#..~..^^..~..#..~..^^..~.
.^.#~..#..^..~~..#..^..~~..#..^^..~..#..
..^..~..#..^^..~..#..~..^^..~..#..~..^^.
.~.~#..~..^^..~..#..~..^^..~..#..^^..~..
..^^.#..^..~~..#..^..~~..#..^..~~..#..^.
.^..~~..^..#..^^..~..#..^..~~..^..#..~..
.#~..^^..#..~..^..~~..#..~..^..^^..#..~.
.~..^..~~..^..#..^^..~..#..^..~~..^..#..
.~^..~.~^^..~..#..~..^^..~..#..~..^^..~.
.^..~~.~#..^..~~..#..^..~~..#..^^..~..#.
..~..^.^~~..^..#..^^..~..#..^..~~..^..#.
.~..^^..~..#..~..^^..~..#..~..^^..~..#..
..~..^..~~..#..^..~~..#..^..~~..#..^^..~
.^..~~..#..^..~~..^..#..^^..~..#..^..~~.
..^..~..^^..~~.#..~..^^..~..#..~..^^..~.
.~..#..~..^^..~..#..~..^^..~..#..^^..~..
..~..#..^..~~..#..^..~~..#..^..~~..#..^.
.^..~~..^..#..^^.#~..#..^..~~..^..#..~..
..~..^^..#..~..^..~~..#..~..^..^^..#..~.
.~..^..~~..^..#..^^..~..#..^..~~..^..#..
..^..~..^^..~..#..~.~^^#.~..#..~..^^..~.
.^..~~..#..^..~~..#..^..~~..#..^^..~..#.
..~..^..~~..^..#..^^.^~..#..^..~~..^..#.
.~..^^..~..#..~..^^..~..#..~..^^..~..#..
..~..^..~~..#..^..~~..#..^..~~..#..^^..~
.^..~~..#..^..~~..^..#..^^..~..#..^..~~.
..^..~..^^..~..#..~..^^..~~.#..~..^^..~.
.~..#..~..^^..~..#..~..^^..~..#..^^..~..
..~..#..^..~~..#..^..~~..#..^..~~..#..^.
.^..~~..^..#..^^..~..#..^..~~..^..#..~..
..~..^^..#..~..^..~~..#..~..^..^^..#.^~.
.~..^..~~..^..#..^^..~..#..^..~~..^.##..
..^..~..^^.^~..#..~..^^..~..#..~..^^..G.
